NO ./Txtr/ghost.xpm
WE ./Txtr/txtr.xpm
SO ./Txtr/grosse weed wall.xpm
EA    ./Txtr/txtr.xpm

F 150,100,50
C 100,255,254

        1111111111111111111111111
        1000000000110000000000001
        1011000001110000000000001
        1001000003040000000000001
111111111011000001110000003000001
120000000011000001110111114111111
11114111111111411100000010001
11113111111111011101010010001
11000000110101011100000010001
10000000000000001100000010001
10000000000000001101010010001
11000001110101011111211110N01
11110111 11101000211111110201
11111111 111111111      11111

