R 1000 1000

NO ./Txtr/no_txtr
WE ./Txtr/we_txtr
EA ./Txtr/ea_txtr

S    ./Txtr/sprite_txtr
SO    ./Txtr/so_txtr

F 254,0,0
C 0,0,254


        1111111111111111111111111
        1000000000110000000000001
        10110000011100000000W0001
        1001000000000000000000001
111111111011000001110000000000001
100000000011000001110111110111111
11110111111111011100000010001
11110111111111011101010010001     11111
11000000110101011100000010001     10001
10002000000000001100000010001     10001
10000000000000001101010010001     10001
1100000111010101111101111000111   11111
11110111 1110101 101111010001
11111111 1111111 111111111111


