R 1920 1080

NO ./Txtr/chain.xpm
WE ./Txtr/yingyang.xpm
EA ./Txtr/cube.xpm

S    ./Txtr/txtr.xpm
SO    ./Txtr/satan.xpm

F 150,100,50
C 100,0,254


1111111111111111111111111111111
1000000000000000000000000000001
1000000000000000000000000000001
1001001001001001001001001001001
1000000000000000000000000000001
1000000000000000000000000000001
1001001001001001001001001001001
1000000000000000000000000000001
1000000000000000000000000000001
1001001001001001001001001001001
1000000000000000000000000000001
1000000000000000000000000000001
1001001001001001001001001001001
1000000000000000000000000000001
1000000000000000000000000000001
1001001001001001001001001001001
1000000000000000000000000000001
1000000000000N00000000000000001
1111111111111111111111111111111


