

NO ./Txtr/grasswall.xpm
WE ./Txtr/grasswall.xpm
SO ./Txtr/grasswall.xpm
EA    ./Txtr/grasswall.xpm

F 150,100,50
C 100,255,254

                             1111111111
                   1111111   1000000001
                   10000011111411410141
                   10101000044441410141
1111111111111111111111011111111411131411111111
1000000000000104300000000100001441141000000031
111011111000000111101111012110111114410000000111
121010001011111101000101001010100001100000000401
100000101000030100010000100000100000000000020101
111111111111141111111111111111111111111111111101
111444411111141100010000001003400000000000000101
111411411444441100000011101000100000000000000101
111441441411111101111012101000100000000W00000101
111141111411111100001000100000100000000000002101
1114444444411111111411111111111111111111111111001
111411111141101111131                        1101
100000000000100000001                         101
11110111111111111011111                       101
10000000000003400000121                       101
11111110111111100111101                       101
10010000000102100000001                       101
10000100010000100000111                       101
1111111111111111114111111111111111111111111111101
0000000000000000103010000000000000000000000000001
                144410111111111111111111111111111
                1000001
                1111111