NO         ./Txtr/grosse weed wall.xpm
WE ./Txtr/grosse weed wall.xpm
SO ./Txtr/grosse weed wall.xpm
EA ./Txtr/grosse weed wall.xpm

F 150,100,50
C 100,255,254

11110
10001
1S001
11011
  100