R 1000 1000

NO ./path_to_the_north_texture
WE ./path_to_the_west_texture
EA ./path_to_the_east_texture

S    ./path_to_the_sprite_texture
SO    ./path_to_the_south_texture

F 220,100,0
C 225,30,0

 000000000000000000000
 111111010000101111110
 100000010000101000010
 100000010000101000010
 100000010000101000010
 100000010000101000010
 100000010000101111100
 100000010000101000010
 100000010000101000010
 100000010000101000010
 100000010000101000010
 111111011111101111110
 000000000000000000000




